9,9,9,9,9,9,9,9,9,9,9,9,9,9,9,9,9,9,9,9,9,9,9,9,9,9,9,9,9,9,9,9,9,9,9,9,9,9,9,9,9,9,9,9,9,9,9,9,9,9,9,9,9,9,9,9,9,9,9,9,9,9,9,9,9,9,9,9,9,9,9,9,9,9,9,9,9,9,9,9
9,6,2,2,2,2,2,8,8,8,8,8,8,8,8,8,8,8,8,8,8,8,8,8,3,6,2,2,2,2,2,2,4,3,8,8,8,0,0,0,0,0,0,0,0,8,8,8,3,4,8,8,8,8,8,6,2,2,3,8,8,8,8,8,8,8,8,8,8,8,8,8,8,2,2,2,2,2,6,9
9,2,2,2,2,2,2,8,8,8,8,8,8,8,8,8,8,8,8,8,8,8,8,8,3,2,2,2,2,2,2,2,0,3,8,8,8,0,0,0,0,0,0,0,0,8,8,8,3,0,8,8,8,8,8,8,2,2,3,8,8,8,8,8,8,8,8,8,8,8,8,8,8,2,2,2,2,2,2,9
9,2,2,2,2,2,2,8,8,8,8,8,8,8,8,8,8,8,8,8,8,8,8,8,3,2,2,2,2,2,2,2,0,3,8,8,8,0,0,0,0,0,0,0,0,8,8,8,3,0,8,8,8,8,8,8,2,2,3,8,8,8,8,8,8,8,8,8,8,8,8,8,8,2,2,2,2,2,2,9
9,2,2,2,2,2,2,8,8,8,8,8,8,8,8,8,8,8,8,8,8,8,8,8,0,2,2,2,2,2,2,2,0,3,8,8,8,0,0,0,0,0,0,0,0,8,8,8,3,0,8,8,8,8,8,8,2,2,0,8,8,8,8,8,8,8,8,8,8,8,8,8,8,2,2,2,2,2,2,9
9,2,2,2,2,2,2,8,8,8,8,8,8,8,8,8,8,8,8,8,8,8,8,8,0,2,2,2,2,2,2,2,0,3,8,8,8,0,0,0,0,0,0,0,0,8,8,8,3,0,8,8,8,8,8,8,2,2,0,8,8,8,8,8,8,8,8,8,8,8,8,8,8,2,2,2,2,2,2,9
9,2,2,2,2,2,2,8,8,8,8,8,8,8,8,8,8,8,8,8,8,8,8,8,0,2,2,2,2,2,2,2,0,3,0,0,0,0,0,0,0,0,0,0,0,0,0,0,3,0,8,8,8,8,8,8,2,2,0,8,8,8,8,8,8,8,8,8,8,8,8,8,8,2,2,2,2,2,2,9
9,2,2,2,2,2,2,8,8,8,8,8,8,8,8,8,8,8,8,8,8,8,8,8,0,2,2,2,2,2,2,2,0,3,0,0,0,0,0,0,0,0,0,0,0,0,0,0,3,0,8,8,8,8,8,8,2,2,0,8,8,8,8,8,8,8,8,8,8,8,8,8,8,2,2,2,2,2,2,9
9,2,2,2,2,2,2,8,8,8,8,8,8,8,8,8,8,8,8,8,8,8,8,8,0,2,2,2,2,2,2,2,0,3,0,0,0,0,0,0,0,0,0,0,0,0,0,0,3,0,8,8,8,8,8,8,2,2,0,8,8,8,8,8,8,8,8,8,8,8,8,8,8,2,2,2,2,2,2,9
9,2,2,2,2,2,2,8,8,8,8,8,8,8,8,8,8,8,8,8,8,8,8,8,0,2,2,2,2,2,2,2,0,3,0,0,0,0,0,0,0,0,0,0,0,0,0,0,3,0,8,8,8,8,8,8,2,2,0,0,0,0,0,0,0,3,0,0,0,2,2,2,2,3,5,0,0,0,0,9
9,0,0,0,0,5,3,2,2,2,2,0,0,0,3,0,0,0,0,0,0,0,0,0,0,2,2,2,2,2,2,2,0,3,0,0,0,0,7,7,7,7,7,7,0,0,0,0,3,0,8,8,8,8,8,8,2,2,0,0,0,0,0,0,0,3,0,0,0,2,2,2,2,3,0,0,0,0,0,9
9,0,0,0,0,0,3,2,2,2,2,0,0,0,3,0,0,0,0,0,0,0,0,0,0,2,2,2,2,2,2,2,0,3,0,0,0,0,7,7,7,7,7,7,0,0,0,0,3,0,8,8,8,8,8,8,2,2,0,0,0,0,0,0,0,3,0,0,0,2,2,2,2,3,0,0,0,0,0,9
9,0,0,0,0,0,3,2,2,2,2,0,0,0,3,0,0,0,0,0,0,0,0,0,0,2,2,2,2,2,2,2,0,3,0,0,0,0,7,7,7,7,7,7,0,0,0,0,3,0,8,8,8,8,8,8,2,2,0,0,0,0,0,0,0,3,0,0,0,2,2,2,2,3,0,0,0,0,0,9
9,5,0,0,0,0,3,2,2,2,2,0,0,0,3,0,0,0,0,0,0,0,0,0,0,2,2,2,2,2,2,2,0,0,0,0,0,7,7,7,7,7,7,7,7,0,0,0,0,0,8,8,8,8,8,8,2,2,0,0,0,0,0,0,0,3,0,0,0,2,2,2,2,3,0,0,0,0,0,9
9,0,0,0,0,0,3,2,2,2,2,0,0,0,3,0,0,0,0,0,0,0,0,0,0,2,2,2,2,2,2,2,0,0,0,0,0,7,7,7,7,7,7,7,7,0,0,0,0,0,8,8,8,8,8,8,2,2,0,0,0,0,0,0,0,0,0,0,0,2,2,2,2,3,0,0,0,0,0,9
9,0,0,0,0,0,3,2,2,2,2,0,0,0,3,0,0,0,0,0,0,0,0,0,0,0,0,2,2,2,2,2,0,0,0,0,0,7,7,7,7,7,7,7,7,0,0,0,0,0,8,8,8,8,8,8,0,0,0,0,0,0,0,0,0,0,0,0,0,2,2,2,2,3,0,0,0,0,0,9
9,0,0,0,0,0,3,2,2,2,2,0,0,0,0,2,2,2,2,0,0,0,0,0,0,0,0,2,2,2,2,2,0,0,0,0,7,7,7,7,7,7,7,7,7,7,0,0,0,0,8,8,8,8,8,8,0,0,0,0,0,0,0,0,0,0,0,0,0,2,2,2,2,3,0,0,0,0,0,9
9,0,0,0,0,0,3,2,2,2,2,0,0,0,0,2,2,2,2,0,0,0,0,0,0,0,0,2,2,2,2,2,0,0,0,0,7,7,7,7,7,7,7,7,7,7,0,0,0,0,8,8,8,8,8,8,0,0,0,0,0,0,0,0,0,0,0,0,0,2,2,2,2,3,0,0,0,0,0,9
9,0,0,0,0,0,3,2,2,2,2,0,0,0,0,2,2,2,2,0,0,0,0,0,0,0,0,2,2,2,2,2,0,0,0,0,7,7,7,7,7,7,7,7,7,7,0,0,0,0,0,0,0,0,0,0,0,0,0,0,0,0,0,0,0,0,0,0,0,2,2,2,2,3,0,0,0,0,0,9
9,2,2,0,0,0,0,0,0,0,0,0,0,0,0,2,2,2,2,0,0,4,0,0,0,0,0,0,0,0,0,0,0,0,0,7,7,7,4,7,7,7,7,4,7,7,7,0,0,0,0,0,0,0,0,0,0,0,0,0,4,0,0,0,0,0,0,0,0,0,0,0,0,0,0,0,0,2,2,9
9,2,2,0,0,0,0,0,0,0,0,0,0,0,0,2,2,2,2,0,0,0,0,0,0,0,0,0,0,0,0,0,0,0,0,7,7,7,7,7,7,7,7,7,7,7,7,0,0,0,0,0,0,0,0,0,0,0,0,0,0,0,0,0,0,0,0,0,0,0,0,0,0,0,0,0,0,2,2,9
9,2,2,0,0,0,0,0,0,0,0,0,0,0,0,2,2,2,2,0,0,0,0,0,0,0,0,0,0,0,0,0,0,0,0,7,7,7,7,7,7,7,7,7,7,7,7,0,0,0,0,0,0,0,0,0,0,0,0,0,0,0,0,0,0,0,0,0,0,0,0,0,0,0,0,0,0,2,2,9
9,2,2,0,0,0,0,0,0,0,0,0,0,0,0,2,2,2,2,0,0,0,0,0,0,0,0,0,0,0,0,0,0,0,7,7,7,7,7,7,7,7,7,7,7,7,7,7,0,0,0,0,0,0,0,0,0,0,0,0,0,0,0,0,0,0,0,0,0,0,0,0,0,0,0,0,0,2,2,9
9,2,2,0,0,0,0,0,0,0,0,0,0,0,0,2,2,2,2,0,0,0,0,0,0,0,0,0,0,0,0,0,0,0,7,7,7,7,7,7,7,7,7,7,7,7,7,7,0,0,0,0,0,0,0,0,0,0,0,0,0,0,0,0,0,0,0,0,0,0,0,0,0,0,0,0,0,2,2,9
9,2,2,0,4,8,8,8,7,7,8,8,8,0,0,2,2,2,2,0,0,0,0,0,0,0,0,0,0,0,0,0,0,0,7,7,7,7,7,7,7,7,7,7,7,7,7,7,0,0,0,0,0,0,0,0,0,0,0,0,0,0,0,0,0,0,0,8,8,8,7,7,8,8,8,4,0,2,2,9
9,0,0,0,0,8,8,8,7,7,8,8,8,0,0,0,0,0,0,0,0,0,0,0,0,0,0,0,0,0,0,0,8,8,7,7,7,7,7,7,6,5,7,7,7,7,7,7,8,8,0,0,0,0,0,0,0,0,0,0,0,0,0,0,0,0,0,8,8,8,7,7,8,8,8,0,0,0,0,9
9,0,0,0,0,8,8,8,7,7,8,8,8,0,0,0,0,0,0,0,0,0,0,0,0,0,0,0,0,0,0,0,8,8,7,7,7,7,7,7,7,7,7,7,7,7,7,7,8,8,0,0,0,0,0,0,0,0,0,0,0,0,0,0,0,0,0,8,8,8,7,7,8,8,8,0,0,0,0,9
9,0,0,0,0,8,8,8,7,7,8,8,8,0,0,0,0,0,0,0,0,0,0,0,0,3,0,0,0,0,0,0,8,8,7,7,7,7,7,7,7,7,7,7,7,7,7,7,8,8,0,0,0,0,0,0,0,3,0,0,0,0,0,0,0,0,0,8,8,8,7,7,8,8,8,0,0,0,0,9
9,0,0,0,0,8,8,8,7,7,8,8,8,0,0,0,0,0,0,0,0,0,0,0,0,3,0,0,0,0,0,0,8,8,7,7,7,7,7,7,7,7,7,7,7,7,7,7,8,8,0,0,0,6,0,0,0,3,0,0,0,0,0,0,0,0,0,8,8,8,7,7,8,8,8,0,0,0,0,9
9,0,0,0,0,8,8,8,7,7,8,8,8,0,0,0,0,0,0,0,0,0,0,0,0,3,0,0,6,0,0,0,8,8,7,7,7,7,7,7,7,7,7,7,7,7,7,7,8,8,0,0,0,0,0,0,0,3,5,0,0,0,0,0,0,0,0,8,8,8,7,7,8,8,8,0,0,0,0,9
9,0,0,0,0,8,8,8,7,7,8,8,8,0,0,0,0,0,0,0,0,0,0,0,0,3,0,0,0,0,0,0,8,8,7,7,7,7,7,7,5,6,7,7,7,7,7,7,8,8,0,0,0,0,0,0,0,3,0,0,0,0,0,0,0,0,0,8,8,8,7,7,8,8,8,0,0,0,0,9
9,0,0,0,0,8,8,8,7,7,8,8,8,0,0,0,0,0,0,0,0,0,0,0,0,0,0,0,0,0,0,0,8,8,7,7,7,7,7,7,7,7,7,7,7,7,7,7,8,8,0,0,0,0,0,0,0,0,0,0,0,0,0,0,0,0,0,8,8,8,7,7,8,8,8,0,0,0,0,9
9,0,0,0,0,8,8,8,7,7,8,8,8,0,0,0,0,0,0,0,0,0,0,0,0,0,0,0,0,0,0,0,8,8,7,7,7,7,7,7,7,7,7,7,7,7,7,7,8,8,0,0,0,0,0,0,0,0,0,0,0,0,0,0,0,0,0,8,8,8,7,7,8,8,8,0,0,0,0,9
9,0,0,0,0,8,8,8,7,7,8,8,8,0,0,0,0,0,0,0,0,0,0,0,0,0,0,0,0,0,0,0,0,0,7,7,7,7,7,7,7,7,7,7,7,7,7,7,0,0,0,0,0,0,0,0,0,0,0,0,0,0,0,0,0,0,0,8,8,8,7,7,8,8,8,0,0,0,0,9
9,0,0,0,0,8,8,8,7,7,8,8,8,0,0,0,0,0,0,0,0,0,0,0,0,0,0,0,0,0,0,0,0,0,7,7,7,7,7,7,7,7,7,7,7,7,7,7,0,0,0,0,0,0,0,0,0,0,0,0,0,0,0,0,0,0,0,8,8,8,7,7,8,8,8,0,0,0,0,9
9,0,0,0,0,8,8,8,7,7,8,8,8,0,0,2,2,2,2,0,0,0,0,0,0,0,0,0,0,0,0,0,0,0,7,7,7,7,7,7,7,7,7,7,7,7,7,7,0,0,0,0,0,0,0,0,0,0,0,0,0,0,2,2,2,2,0,8,8,8,7,7,8,8,8,0,0,0,0,9
9,2,2,0,0,0,0,0,0,0,0,0,0,0,0,2,2,2,2,0,0,0,0,0,0,0,0,0,0,0,0,0,0,0,0,7,7,7,7,7,7,7,7,7,7,7,7,0,0,0,0,0,0,0,0,0,0,0,0,0,0,0,2,2,2,2,0,0,0,0,0,0,0,0,0,0,0,2,2,9
9,2,2,0,0,0,0,0,0,0,0,0,0,0,0,2,2,2,2,0,0,0,0,0,0,0,0,0,0,0,0,0,0,0,0,7,7,7,7,7,7,7,7,7,7,7,7,0,0,0,0,0,0,0,0,0,0,0,0,0,0,0,2,2,2,2,0,0,0,0,0,0,0,0,0,0,0,2,2,9
9,2,2,0,0,0,0,0,0,0,0,0,0,0,0,2,2,2,2,0,0,0,0,0,0,0,0,0,0,0,0,0,0,0,0,7,7,7,4,7,7,7,7,4,7,7,7,0,0,0,0,0,0,0,0,0,0,0,0,0,0,0,2,2,2,2,0,0,0,0,0,0,0,0,0,0,0,2,2,9
9,2,2,0,0,0,0,0,0,0,0,0,0,0,0,2,2,2,2,0,0,4,0,0,0,0,0,0,0,0,0,0,0,0,0,7,7,7,7,7,7,7,7,7,7,7,7,0,0,0,0,0,0,0,0,0,0,0,0,0,4,0,2,2,2,2,0,0,0,0,0,0,0,0,0,0,0,2,2,9
9,2,2,0,0,0,0,0,0,0,0,0,0,0,0,2,2,2,2,0,0,0,0,0,0,0,0,0,0,0,0,0,0,0,0,7,7,7,7,7,7,7,7,7,7,7,7,0,0,0,0,0,0,0,0,0,0,0,0,0,0,0,2,2,2,2,0,0,0,0,0,0,0,0,0,0,0,2,2,9
9,2,2,0,0,0,3,2,2,2,2,0,0,0,0,2,2,2,2,0,0,0,0,0,0,0,0,0,0,0,0,0,0,0,0,0,7,7,7,7,7,7,7,7,7,7,0,0,0,0,0,0,0,0,0,0,0,0,0,0,0,0,2,2,2,2,0,0,0,2,2,2,2,3,0,0,0,2,2,9
9,0,0,0,0,0,3,2,2,2,2,0,0,0,0,2,2,2,2,0,0,0,0,0,0,0,0,0,0,0,0,0,0,0,0,0,7,7,7,7,7,7,7,7,7,7,0,0,0,0,2,2,2,2,2,2,0,0,0,0,0,0,2,2,2,2,0,0,0,2,2,2,2,3,0,0,0,0,0,9
9,0,0,0,0,0,3,2,2,2,2,0,0,0,0,2,2,2,2,0,0,0,0,0,0,0,0,0,0,0,0,0,0,0,0,0,7,7,7,7,7,7,7,7,7,7,0,0,0,0,2,2,2,2,2,2,0,0,0,0,0,0,2,2,2,2,0,0,0,2,2,2,2,3,0,0,0,0,0,9
9,0,0,0,0,0,3,2,2,2,2,0,0,0,3,0,0,0,0,0,0,0,0,0,0,0,0,8,8,8,8,8,0,0,0,0,0,7,7,7,7,7,7,7,7,0,0,0,0,0,2,2,2,2,2,2,0,0,0,0,0,0,2,2,2,2,0,0,0,2,2,2,2,3,0,0,0,0,0,9
9,0,0,0,0,0,3,2,2,2,2,0,0,0,3,0,0,0,0,0,0,0,0,0,0,2,2,8,8,8,8,8,0,0,0,0,0,7,7,7,7,7,7,7,7,0,0,0,0,0,2,2,2,2,2,2,2,2,0,0,0,0,0,0,0,3,0,0,0,2,2,2,2,3,0,0,0,0,0,9
9,0,0,0,0,0,3,2,2,2,2,0,0,0,3,0,0,0,0,0,0,0,0,0,0,2,2,8,8,8,8,8,0,0,0,0,0,7,7,7,7,7,7,7,7,0,0,0,0,0,2,2,2,2,2,2,2,2,0,0,0,0,0,0,0,3,0,0,0,2,2,2,2,3,0,0,0,0,0,9
9,0,0,0,0,0,3,2,2,2,2,0,0,0,3,0,0,0,0,0,0,0,0,0,0,2,2,8,8,8,8,8,0,0,0,0,0,0,7,7,7,7,7,7,0,0,0,0,0,0,2,2,2,2,2,2,2,2,0,0,0,0,0,0,0,3,0,0,0,2,2,2,2,3,0,0,0,0,0,9
9,0,0,0,0,0,3,2,2,2,2,0,0,0,3,0,0,0,0,0,0,0,0,0,0,2,2,8,8,8,8,8,0,3,0,0,0,0,7,7,7,7,7,7,0,0,0,0,3,0,2,2,2,2,2,2,2,2,0,0,0,0,0,0,0,3,0,0,0,2,2,2,2,3,0,0,0,0,0,9
9,0,0,0,0,5,3,2,2,2,2,0,0,0,3,0,0,0,0,0,0,0,0,0,0,2,2,8,8,8,8,8,0,3,0,0,0,0,7,7,7,7,7,7,0,0,0,0,3,0,2,2,2,2,2,2,2,2,0,0,0,0,0,0,0,3,0,0,0,2,2,2,2,3,0,0,0,0,0,9
9,2,2,2,2,2,8,8,8,8,8,8,8,8,8,8,8,8,8,8,8,8,8,0,0,2,2,8,8,8,8,8,0,3,0,0,0,0,0,0,0,0,0,0,0,0,0,0,3,0,2,2,2,2,2,2,2,2,0,0,0,0,0,0,0,3,0,0,0,2,2,2,2,3,5,0,0,0,0,9
9,2,2,2,2,2,8,8,8,8,8,8,8,8,8,8,8,8,8,8,8,8,8,0,0,2,2,8,8,8,8,8,0,3,0,0,0,0,0,0,0,0,0,0,0,0,0,0,3,0,2,2,2,2,2,2,2,2,0,8,8,8,8,8,8,8,8,8,8,8,8,8,8,2,2,2,2,2,2,9
9,2,2,2,2,2,8,8,8,8,8,8,8,8,8,8,8,8,8,8,8,8,8,0,0,2,2,8,8,8,8,8,0,3,0,0,0,0,0,0,0,0,0,0,0,0,0,0,3,0,2,2,2,2,2,2,2,2,0,8,8,8,8,8,8,8,8,8,8,8,8,8,8,2,2,2,2,2,2,9
9,2,2,2,2,2,8,8,8,8,8,8,8,8,8,8,8,8,8,8,8,8,8,0,0,2,2,8,8,8,8,8,0,3,0,0,0,0,0,0,0,0,0,0,0,0,0,0,3,0,2,2,2,2,2,2,2,2,0,8,8,8,8,8,8,8,8,8,8,8,8,8,8,2,2,2,2,2,2,9
9,2,2,2,2,2,8,8,8,8,8,8,8,8,8,8,8,8,8,8,8,8,8,0,0,2,2,8,8,8,8,8,0,3,8,8,8,0,0,0,0,0,0,0,0,8,8,8,3,0,2,2,2,2,2,2,2,2,0,8,8,8,8,8,8,8,8,8,8,8,8,8,8,2,2,2,2,2,2,9
9,2,2,2,2,2,8,8,8,8,8,8,8,8,8,8,8,8,8,8,8,8,8,0,0,2,2,8,8,8,8,8,0,3,8,8,8,0,0,0,0,0,0,0,0,8,8,8,3,0,2,2,2,2,2,2,2,2,0,8,8,8,8,8,8,8,8,8,8,8,8,8,8,2,2,2,2,2,2,9
9,2,2,2,2,2,8,8,8,8,8,8,8,8,8,8,8,8,8,8,8,8,8,0,3,2,2,8,8,8,8,8,0,3,8,8,8,0,0,0,0,0,0,0,0,8,8,8,3,0,2,2,2,2,2,2,2,2,3,8,8,8,8,8,8,8,8,8,8,8,8,8,8,2,2,2,2,2,2,9
9,2,2,2,2,2,8,8,8,8,8,8,8,8,8,8,8,8,8,8,8,8,8,0,3,2,2,8,8,8,8,8,0,3,8,8,8,0,0,0,0,0,0,0,0,8,8,8,3,0,2,2,2,2,2,2,2,2,3,8,8,8,8,8,8,8,8,8,8,8,8,8,8,2,2,2,2,2,2,9
9,6,2,2,2,2,8,8,8,8,8,8,8,8,8,8,8,8,8,8,8,8,8,0,3,6,2,8,8,8,8,8,4,3,8,8,8,0,0,0,0,0,0,0,0,8,8,8,3,4,2,2,2,2,2,6,2,2,3,8,8,8,8,8,8,8,8,8,8,8,8,8,8,2,2,2,2,2,6,9
9,9,9,9,9,9,9,9,9,9,9,9,9,9,9,9,9,9,9,9,9,9,9,9,9,9,9,9,9,9,9,9,9,9,9,9,9,9,9,9,9,9,9,9,9,9,9,9,9,9,9,9,9,9,9,9,9,9,9,9,9,9,9,9,9,9,9,9,9,9,9,9,9,9,9,9,9,9,9,9